WWWWWWWWWWWWWWWWWWWWWWWWWWWWWWWWWWWWWWWWWWWWWWWWWWWWWWWWWWWWWWWWWWWWWWWWWWWWWWWW
W                           W           W            W                         W
W                           W           W            W                         W
W                           W           W            W                         W
W                           W           W            W                         W
W                           W           W            W             /           W
W                           W           W            W                         W
W                                       W            W                         W
W                                       W            W                         W
W                           W           W            W                         W
W                           W           W            W                         W
W                           W     ***   W            W                         W
W                           W     *?*   W      WWWWWWWWWWWWWWWWWWWWWWWWWW      W
W                           W     ***   W                                      W
W                           W           W                                      W
W                           W           W                                      W
W                           W                                  4444            W
W               T           W                                  4444            W
W                           W                                  4444            W
W                           W           W                      4444            W
WWWWWWWWWWWWWWWWWWWWWWWWWWWWWWWWWWWWWWWWWWWWWWWWWWWWWWWWWWWWWWWWWWWWWWWWWWWWWWWW
