WWWWWWWWWWWWWWWWWWWWWWWWWWWWWWWWWWWWWWWWWWWWWWWWWWWWWWWWWWWWWWWWWWWWWWWWWWWWWWWW
W  3  3    W                      W     W                                      W
W  3  3    W                      W     W                                      W
W  3  3    W                      W     W                                      W
W  3333    W                      W     W                                      W
W          W                      W  S  W                                      W
W          W                      W     W                                      W
W          W                      W     W                                      W
W          W                      W     W                                      W
W          W                      W     W                                      W
W          WWWWWWWWWWWWWWWWWWWWWWWWWWWWWWWWWWWWWWWWWWWWWWWWWWWWWWWWWWWWWWWWWWWWW
W                                                                              W
W                                                                              W
W                                                                       4444   W
W     ***                                                               4444   W
W     *?*                      B                                        4444   W
W     ***                                                               4444   W
WWWWWWWWWWWWWWWWWWWWWWWWWWWWWWWWWWW    WWWWWWWWWWWWWWWWWWWWWWWWWWWWWWWWWWWWWWWWW
W                                 W     W                                      W
W                                 W     W                                      W
WWWWWWWWWWWWWWWWWWWWWWWWWWWWWWWWWWWWWWWWWWWWWWWWWWWWWWWWWWWWWWWWWWWWWWWWWWWWWWWW
