WWWWWWWWWWWWWWWWWWWWWWWWWWWWWWWWWWWWWWWWWWWWWWWWWWWWWWWWWWWWWWWWWWWWWWWWWWWWWWWW
W      3  3                                                                    W
W      3  3                                                                    W
W      3  3                    WWWW                                            W
W      3333                                                                    W
W                     WWW                                                      W
W                     W W                                                      W
W                     WWW                                                      W
W                                                                              W
W                                              WWW                             W
W                                              W W                             W
W                                              WWW                             W
W             ***                                                              W
W             *?*                                                              W
W             ***           WWW                                                W
W                           W W                                                W
W                                                                              W
W###     X       P                                         4444                W
W                                                          4444                W
W                                                          4444                W
W                                                          4444                W
W                                                                              W
W                                                                              W
W                                                                              W
WWWWWWWWWWWWWWWWWWWWWWWWWWWWWWWWWWWWWWWWWWWWWWWWWWWWWWWWWWWWWWWWWWWWWWWWWWWWWWWW
